xxxxxxxxxxxxxxxxxxxxxxxxxxxxxxxxxxxxxxx
x.....................................x
x.....................................x
x.....................................x
x.....................................x
x...................P.................x
x.....................................x
x.....................................x
x.....................................x
x.....................xx..............x
x.....................xx..............x
x.....................................x
x.....................................x
x.....................................x
x.....................................x
x.....................................x
x.....................................x
x.....................................x
xxxxxxxxxxxxxxxxxxxxxxxxxxxxxxxxxxxxxxx